{
    "map1": [
        "XXXXXXXXXXXXXXXX",
        "X..............X",
        "X..............X",
        "XXXXXXXXXXXXXX.X",
        "X..............X",
        "X....X..X......X",
        "XXXXXX..X......X",
        "X.......XXXXXXXX",
        "XXX..XXXX......X",
        "X.......XXX.XXXX",
        "X....X..X......X",
        "X.......X..XX..X",
        "X...XX..X......X",
        "X.......XXX.XX.X",
        "X..............X",
        "XXXXXXXXXXXXXXXX"
    ],
    "map2": [
        "XXXXXXXXXXXXXXXX",
        "X..............X",
        "X..............X",
        "XXXX...........X",
        "X..............X",
        "X..XXXXXXXXX...X",
        "X..X.......X...X",
        "X..X.......X...X",
        "X..X.......X...X",
        "X..X.......X...X",
        "X..XXXX.XXXX...X",
        "X..............X",
        "X..............X",
        "X..............X",
        "X..............X",
        "XXXXXXXXXXXXXXXX"
    ],
    "map3": [
        "XXXXXXXXXXXXXXXX",
        "X..............X",
        "X..............X",
        "X..............X",
        "X..............X",
        "X..XXXXXXXXXX..X",
        "X..X........X..X",
        "X..X...........X",
        "X..X........X..X",
        "X..XXXXXXXXXX..X",
        "X..............X",
        "XXXXXXXXXXXXXXXX"
    ]
}