{
    "map1": [
        "XXXXXXXXXXXXXXXX",
        "X..............X",
        "X..............X",
        "XXXXXXXXXXXXXX.X",
        "X..XXX......ww.X",
        "X..XXX..X.wooo.X",
        "XXXXXX..X......X",
        "X.......XXXXXXXX",
        "XXX.oXXXX......X",
        "X....w..XXX.XXXX",
        "X....X..X......X",
        "X....w..XooXXw.X",
        "X.ooXX..X......X",
        "X....o..XXXoXX.X",
        "X..............X",
        "XXXXXXXXXXXXXXXX"
    ],
    "map2": [
        "XXXXXXXXXXXXXXXX",
        "X........o.o...X",
        "X........owooo.X",
        "XXXXo......w...X",
        "X..........o...X",
        "X..XXXXXXXXXwwwX",
        "X..X.......X...X",
        "X..X.......Xoo.X",
        "X..X.......X...X",
        "X..X.......X...X",
        "X..XXXX.XXXX...X",
        "X..............X",
        "X..............X",
        "X..............X",
        "X..............X",
        "XXXXXXXXXXXXXXXX"
    ],
    "map3": [
        "XXXXXXXXXXXXXXXX",
        "X......w...o...X",
        "X......o.o.wwwwX",
        "X......ooo.....X",
        "X..............X",
        "X..XXXXXXXXXX..X",
        "X..X........X..X",
        "X..X...........X",
        "X..X........X..X",
        "X..XXXXXXXXXX..X",
        "X..............X",
        "XXXXXXXXXXXXXXXX"
    ]
}