{
    "map1": [
        "XXXXXXXXXXXXXXXX",
        "X..............X",
        "X..............X",
        "X..............X",
        "X..............X",
        "X..............X",
        "X..............X",
        "X..............X",
        "X..............X",
        "X..............X",
        "X..............X",
        "X..............X",
        "X..............X",
        "X..............X",
        "X..............X",
        "XXXXXXXXXXXXXXXX"
    ],
    "map2": [
        "XXXXXXXXXXXXXXXX",
        "X..............X",
        "X..............X",
        "X..............X",
        "X..............X",
        "X..XXXXXXXXXX..X",
        "X..............X",
        "X..............X",
        "X..............X",
        "X..............X",
        "X..............X",
        "X..............X",
        "X..............X",
        "X..............X",
        "X..............X",
        "XXXXXXXXXXXXXXXX"
    ]
}