{
    "test_map": [
        "XXXXXXXXXXXXXXXX",
        "X..............X",
        "X..............X",
        "X..............X",
        "X..............X",
        "X..............X",
        "X..............X",
        "X..............X",
        "X..............X",
        "X..............X",
        "X..............X",
        "X..............X",
        "X..............X",
        "X..............X",
        "X..............X",
        "XXXXXXXXXXXXXXXX"
    ]
}